0000001110
0001111110
0001111100
0010011100
0111011000
0111111000
1110011100
1111001110
0110000111
0000000001